0011111111100
0010000000100
0010200020100
0010002000100
0010200020100
0010022200100
0010000000100
0011111111100
0000000000000
0000000000000